############
#..........#
####....####
#..........#
#..........#
####....####
#..........#
############